WWWWWWWWWWWWW
WWWWWWWWWWWWW 
WWWWWWWWWWWWW
WWWWWWWWWWWWW  
W11111111111W  
W    PPP    W
W22222222222W 
WWWWWWWWWWWWW 
WWWWWWWWWWWWW  
WWWWWWWWWWWWW 
WWWWWWWWWWWWW
