WWWWWWWWWWWWW 
WWWWWWWWWWWWW
WWWWWWWWWWWWW  
W11111111111W 
W           W
W    PPP    W
W           W
W22222222222W 
WWWWWWWWWWWWW 
WWWWWWWWWWWWW  
WWWWWWWWWWWWW 
